X                             X
X                             X
X                             X
X                             X
X        1           2        X
X       XXX         XXX       X
X           %%%%%%%           X
X           XXXXXXX           X
X        3           4        X
X       XXX         XXX       X
X                             X
X                             X
XXXXXXXXXXXXXXXXXXXXXXXXXXXXXXX